1111111111111111111111111111111111111111
2345678234567823456700000000000000000000
2349078234567823456700000000000000000000
2340078234567823456700000000000000000000
2340078234567823456700000000000000000000
2345678234567823456700000000000000000000
2345678234567890456700000000000000000000
2345678234567800456700000000000000000000
2345678234567800456700000000000000000000
2345678234567823456700000000000000000000
2345678904567823456700000000000000000000
2345678004567823456700000000000000000000
2345678004567823456700000000000000000000
2345678234567823456700000000000000000000
1000000000000000000000000000000000000001
1000000000000000000000000000000000000001
1000000000000000000000000000000000000001
1000000000000000000000000000000000000001
1000000000000000000000000000000000000001
1000000000000000000000000000000000000001
1000000000000000000000000000000000000001
1000000000000000000000000000000000000001
1000000000000000000000000000000000000001
1000000000000000000000000000000000000001
1000000000000000000000000000000000000001
1000000000000000000000000000000000000001
1000000000000000000000000000000000000001
1000000000000000000000000000000000000001
1000000000000000000000000000000000000001
1111111111111111111111111111111111111111